abide	abode	abode	respecter
arise	arose	arisen	survenir
awake	awoke	awoken	se réveiller
be	was/were	been	être
bear	bore	born	taper
beat	beat	beaten	battre
become	became	become	devenir
beget	begot	begotten	engendrer	
begin	began	begun	commencer
bend	bent	bent	plier
bet	bet	bet	parier
bid	bid	bid	offrir
bind	bound	bound	?
bite	bit	bitten	mordre
bleed	bled	bled	saigner
blow	blew	blown	souffler
break	broke	broken	briser
breed	bred	bred	se reproduire
bring	brought	brought	apporter
*broadcast	broadcast	broadcast	diffuser
build	built	built	construire
*burn	burnt	burnt	brûler
burst	burst	burst	éclater
buy	bought	bought	acheter
cast	cast	cast	jeter
catch	caught	caught	attraper
choose	chose	chosen	choisir
*clap	clapt	clapt	taper
*cleave	clove	cloven	fendre
cling	clung	clung	s'accrocher
*clothe	clad	clad	vêtir
come	came	come	venir
cost	cost	cost	coûter
creep	crept	crept	ramper
*crow	crew	crowed	bonder
cut	cut	cut	couper
deal	dealt	dealt	négocier
dig	dug	dug	creuser
*dive	dove	dived	plonger
do	did	done	faire
draw	drew	drawn	dessiner
*dream	dreamt	dreamt	rêver
drink	drank	drunk	boire
drive	drove	driven	conduire
*dwell	dwelt	dwelt	habiter
eat	ate	eaten	manger
fall	fell	fallen	tomber
feed	fed	fed	nourir
feel	felt	felt	ressentir
fight	fought	fought	combattre
find	found	found	trouver
*fit	fit	fit	répondre à
flee	fled	fled	fuir
fling	flung	flung	lancer
fly	flew	flown	voler
forbid	forbade	forbidden	interdire	
*forecast	forecast	forecast	prévoir
foresee	foresaw	foreseen	anticiper
foretell	foretold	foretold	raconter
forget	forgot	forgotten	oublier
forgive	forgave	forgiven	pardonner
forsake	forsook	forsaken	abandonner
freeze	froze	frozen	geler
get	got	gotten	obtenir
give	gave	given	donner
go	went	gone	aller
grind	ground	ground	moudre
grow	grew	grown	grandir
handwrite	handwrote	handwritten	écrire à la main
hang	hung	hung	accrocher
have	had	had	avoir
hear	heard	heard	entendre
hide	hid	hidden	cacher
hit	hit	hit	frapper
hold	held	held	tenir
hurt	hurt	hurt	faire mal
inlay	inlaid	inlaid	?
*input	input	input	insérer
keep	kept	kept	garder
*kneel	knelt	knelt	s'agenouiller
*knit	knit	knit	tricoter
know	knew	known	savoir
lay	laid	laid	pondre
lead	led	led	mener
*lean	leant	leant	pencher
*leap	leapt	leapt	sauter
*learn	learnt	learnt	apprendre
leave	left	left	laisser
lend	lent	lent	prêter
let	let	let	laisser
lie	lay	lain	se coucher
light	lit	lit	éclairer
lose	lost	lost	perdre
make	made	made	fabriquer
mean	meant	meant	signifier
meet	met	met	rencontrer
*melt	melted	molten	fondre
mislead	misled	misled	tromper
mistake	mistook	mistaken	comprendre à tort
misunderstand	misunderstood	misunderstood	mal interpréter
mow	mowed	mowed	tondre
offset	offset	offset	compenser
overcome	overcame	overcome	surmonter
overhear	overheard	overheard	surprendre
overtake	overtook	overtaken	dépasser
pay	paid	paid	payer
*prove	proved	proven	prouver
put	put	put	mettre
*quit	quit	quit	quitter
read	read	read	lire
*rid	rid	rid	débarrasser
ride	rode	ridden	monter (vélo, cheval)
ring	rang	rung	sonner
rise	rose	risen	lever
run	ran	run	courir
*saw	saw	sawn	scier
say	said	said	dire
see	saw	seen	voir
seek	sought	sought	chercher
sell	sold	sold	vendre
send	sent	sent	envoyer
set	set	set	fixer
shake	shook	shaken	secouer
*shave	shaved	shaven	raser
shine	shone	shone	briller
shoot	shot	shot	tirer
show	showed	shown	montrer
shrink	shrank	shrunk	réduire
shut	shut	shut	fermer
sing	sang	sung	chanter
sink	sank	sunk	couler
sit	sat	sat	s'asseoir
slay	slew	slain	tuer
sleep	slept	slept	dormir
slide	slid	slid	glisser
slink	slunk	slunk	s'en aller furtivement
slit	slit	slit	fendre
smell	smelt	smelt	sentir
sow	sowed	sown	semer
speak	spoke	spoken	parler
speed	sped	sped	aller vite
spell	spelt	spelt	épeler
spend	spent	spent	dépenser
spill	spilt	spilt	renverser
spin	spun	spun	tourner
spit	spat	spat	cracher
split	split	split	fendre
*spoil	spoilt	spoilt	gâcher
spread	spread	spread	répandre
spring	sprang	sprung	surgir
stand	stood	stood	être debout
steal	stole	stolen	voler
stick	stuck	stuck	coller
sting	stung	stung	piquer
stink	stank	stunk	puer
strike	struck	stricken	frapper
swear	swore	sworn	jurer
*sweat	sweat	sweat	suer
sweep	swept	swept	balayer
*swell	swelled	swollen	gonfler
swim	swam	swum	nager
swing	swung	swung	se balancer
take	took	taken	prendre
teach	taught	taught	enseigner
tear	tore	torn	déchirer
tell	told	told	dire
think	thought	thought	penser
*thrive	throve	thriven	prospérer
throw	threw	thrown	jeter
thrust	thrust	thrust	enfoncer
tread	trod	trodden	piétiner quelque chose
undergo	underwent	undergone	subir
understand	understood	understood	comprendre
wake	woke	woken	réveiller
wear	wore	worn	porter (avoir sur soi)
weave	wove	woven	tisser
*wed	wed	wed	marier
weep	wept	wept	pleurer
*wet	wet	wet	mouiller
win	won	won	gagner
wind	wound	wound	enrouler
withdraw	withdrew	withdrawn	se retirer
wring	wrung	wrung	tordre
write	wrote	written	écrire